-1 -1 -1 -1 -1 -1 -1 -1 -1 -1 -1 -1 -1 -1 -1 -1 -1 -1 -1 -1 -1 -1 -1 -1 -1 -1 -1 -1 -1 -1
-1 -1 -1 -1 33 33 -1 -1 -1 -1 -1 -1 -1 -1 -1 -1 -1 -1 -1 -1 -1 -1 -1 -1 -1 -1 -1 -1 -1 -1
-1 -1 -1 -1 33 33 -1 -1 -1 -1 -1 -1 -1 -1 -1 -1 -1 -1 -1 -1 -1 -1 -1 -1 -1 -1 -1 0 1 1
-1 -1 -1 -1 -1 -1 -1 -1 -1 -1 -1 -1 -1 -1 -1 -1 -1 -1 -1 -1 -1 -1 -1 -1 -1 -1 0 161 33 33
-1 -1 -1 -1 -1 -1 -1 -1 -1 -1 -1 -1 -1 -1 -1 -1 -1 -1 -1 -1 -1 -1 -1 -1 -1 -1 35 33 33 197
-1 -1 -1 -1 -1 -1 -1 -1 -1 -1 -1 -1 -1 -1 -1 -1 -1 -1 -1 -1 -1 -1 -1 -1 -1 -1 98 33 33 33
-1 -1 -1 -1 -1 -1 -1 -1 -1 -1 -1 -1 -1 -1 -1 -1 -1 -1 -1 -1 -1 -1 -1 -1 -1 0 66 33 33 33
1 98 163 98 163 98 163 3 -1 -1 -1 -1 -1 -1 -1 -1 -1 -1 -1 -1 -1 -1 -1 -1 -1 98 33 33 33 33
33 33 33 33 33 33 33 32 65 2 -1 -1 -1 -1 -1 -1 -1 -1 -1 -1 -1 -1 -1 -1 0 66 33 33 33 33
33 33 33 33 128 33 33 33 33 32 3 2 -1 -1 -1 -1 -1 -1 -1 -1 -1 -1 -1 -1 35 33 33 67 33 33
229 33 33 33 33 33 33 33 33 33 33 34 -1 -1 -1 -1 -1 -1 -1 -1 -1 -1 -1 -1 131 33 33 33 33 33
33 33 33 33 33 33 33 33 33 33 33 163 -1 -1 -1 -1 -1 -1 -1 -1 -1 -1 -1 -1 32 33 33 33 33 33
33 33 33 33 33 33 33 33 3 33 33 32 37 -1 -1 -1 -1 -1 -1 -1 -1 -1 -1 -1 32 33 33 33 33 33
33 33 33 33 33 33 33 33 33 33 33 33 131 -1 -1 -1 -1 -1 -1 -1 -1 -1 -1 -1 98 33 128 33 33 33
33 33 33 33 164 33 33 33 33 33 33 33 162 -1 -1 -1 -1 -1 -1 -1 -1 -1 -1 0 161 33 160 33 33 33
33 33 33 33 33 33 33 33 33 33 33 33 131 -1 -1 -1 -1 -1 -1 -1 -1 -1 -1 131 33 33 33 33 33 100
33 33 33 33 33 33 33 33 33 33 33 33 162 -1 -1 -1 -1 -1 -1 -1 -1 -1 -1 32 33 33 33 33 33 33
33 33 33 33 33 33 33 161 33 33 33 33 162 -1 -1 -1 -1 -1 -1 -1 -1 -1 -1 35 33 33 33 33 33 33
33 33 33 33 33 33 33 33 33 164 33 33 32 2 -1 -1 -1 -1 -1 -1 -1 -1 -1 32 33 69 33 33 33 33
33 33 37 33 33 33 33 33 33 33 33 33 33 194 -1 -1 -1 -1 -1 -1 -1 -1 -1 131 33 33 33 33 37 33
